11111111111000001
10000200001000001
10001000111000001
10010000001000001
10100000001000001
10000000001000001
10100110001000001
10000000001111111
10000000000000001
11111111111000001
00000000001000001
00000000001111111

